NO ./TODO
SO ./TODO
WE ./TODO
EA ./TODO
F 255,255,0
C 0,0,255



111
10000011
100N0001
1000hola01
10001111
10000011
10001
11111111
11111
111111
