NO ./sprites/42.xpm
SO sprites/sur-good.xpm
WE sprites/window.xpm
EA sprites/este.xpm

F 1,1,25
C 150,150,1

11111
10001
10S01
01111
