NO ./TODO
SO ./TODO
WE ./TODO
EA ./TODO
F 255,255,0
C 0,0,255
      1111111111
     100001111
    10000001
   1000011
  1000111
 100N001
1000001
 1111111
  1111111
   1111111
