NO ./TODO
SO ./TODO
WE ./TODO
EA ./TODO
F 255,255,0
C 0,0,255
111
100000101111
   10000001
   1000011
  1000111
 1000001
1000001
 1100001
  1000011
   1111111