NO ./Remind
SO ./Remind
WE ./Remind
EA ./Remind
F 255,255,0
C 0,0,255




1111111111
100N0111
1001001
1000001
1101 11
1000001
1111011
1111111