NO ./ruta_a_la_textura_norte
SO ./ruta_a_la_textura_sur
WE ./ruta_a_la_textura_oeste
EA ./ruta_a_la_textura_este



F 255,255,0
C 0,0,255


1111111
10000011
100N0001
100001
10001111
10000011
10001
11111111